....................
....................
....................
....................
.r66l...............
.r77l...............
.r11l...............
.r88l..r424l........
.r88l.r453544444l...
.r88l.r5101555554l..
.r114w41111111115l..
.r115451111111111l..
.r111511111111110l..
.r110d01111111111l..
.r110d0111111111l...
.r11l......r101l....
.r99l........t......
....................
....................
....................
