...............................
.R44444444444444444444444444L..
.R55555555555555555555555555L..
.R01111180011111111001111118L..
.R01111111111111111111111117L..
.R11101111111111011111144444L..
.R11004444444411111101155555L..
.R1110555555551e111011111188L..
.R01111117111044411111111119L..
.R01111117111155511111711111L..
.R44444111111111111111111111L..
.R55555111111111111111111711L..
.R11111111199110111144444111L..
.R11111191111111111155555111L..
.R11144441111111111111111111L..
.R011555511111a1111111111111L..
..TTTTTTTTTTTX66ZTTTTTTTTTTT...
.............R66L..............
.............RO2L..............
.............RQ3L..............
