....................
....................
....................
....................
....................
....................
....................
.R44L...............
.R55L...............
.R11L...............
.R88L..R424L........
.R88L.R453544444L...
.R88L.R5171555554L..
.R114W41111111115L..
.R115451111111111L..
.R111511111111117L..
.R117971111111111L..
.R11707111111111Z...
.R11ZTTTTTTX171Z....
.Ra6L.......TTT.....
..TT................
....................
....................
