...............................
.R44444444444444444444444444L..
.R55555555555555555555555555L..
.R11111111111111111111111111L..
.R11111111111111111111111111L..
.R11111111111111111111111111L..
.R11111111111111111111111111L..
.R11111111111111111111111111L..
.R11111111111111111111111111L..
.R11111111111111111111111111L..
.R11111111111111111111111111L..
.R11111111111111111111111111L..
.R11111111111111111111111111L..
.R11111111111111111111111111L..
.R11111111111111111111111111L..
.R111111111111a1111111111111L..
..TTTTTTTTTTTX66ZTTTTTTTTTTT...
.............R66L..............
.............R22L..............
.............R33L..............
