...............................
.R44444444444444444444444444L..
.R55555555555555555555555555L..
.R01111180011111111111111118L..
.R01111111111111111111111117L..
.R11101111111111001111144444L..
.R11004444444411111111155555L..
.R11105555555511111001111111L..
.R01111177111044411111111111L..
.R01111111111155511111711111L..
.R44444111111111111111111111L..
.R55555111187111111111117111L..
.R11111111199110111144444111L..
.R1111119111111e111155555111L..
.R11144441111111111111111111L..
.R011555511111a1111111111111L..
..TTTTTTTTTTTX66ZTTTTTTTTTTT...
.............R66L..............
.............RO2L..............
.............RQ3L..............
