....................
....................
....................
.r44l...............
.r55l...............
.r11l...............
.r88l...............
.r88l...............
.r88l...............
.r11l...............
.r11l...............
.r11l.....r424l.....
.r11l.r44445354l....
.r1144455551015l....
.r1155511111111l....
.r110d011111110l....
.r110d011111111l....
......r1111111l.....
....................
....................
