....................
....................
....................
.r66l...............
.r77l...............
.r11l...............
.r88l...............
.r88l...............
.r88l...............
.r11l...............
.r00l...............
.r11l.....r424l.....
.r11l.r44445354l....
.r1144455551015l....
.r1155511111111l....
.r1111111111110l....
.r1111111111111l....
......r1111111l.....
....................
....................
