....................
....................
....................
....................
...r4466446446644l..
...r5577557557755l..
...r1111111111111l..
...r1111111111111l..
...r1111111111111l..
...r1111111111111l..
...r1111111111111l..
...r1111111111111l..
...r1111111111111l..
...r1111111111111l..
...r1111111111111l..
...r1111111111111l..
...r1111111111111l..
..........r101l.....
....................
....................
